{
  "min_number": 7000,
  "max_number": 10000,
  "target_count": 20,
  "target_tiles": [
    { "x": 3,  "y": 2 },
    { "x": 4,  "y": 2 },
    { "x": 5,  "y": 3 },
    { "x": 6,  "y": 3 },
    { "x": 7,  "y": 2 },
    { "x": 8,  "y": 2 },
    { "x": 9,  "y": 3 },
    { "x": 10, "y": 4 },
    { "x": 10,  "y": 5 },
    { "x": 9,  "y": 6 },
    { "x": 8,  "y": 7 },
    { "x": 7,  "y": 8 },
    { "x": 6,  "y": 9 },
    { "x": 5,  "y": 9 },
    { "x": 4,  "y": 8 },
    { "x": 3,  "y": 7 },
    { "x": 2,  "y": 6 },
    { "x": 1,  "y": 5 },
    { "x": 1,  "y": 4 },
    { "x": 2,  "y": 3 }
  ]
}
